##### #####
#.#@.##...#
#.........#
#.....0.X.#
###### ####
